8,8
2,2,2,2,2,2,2,2
2,2,2,1,2,2,2,2
2,2,2,0,2,2,2,2
2,2,2,0,0,0,1,2
2,1,0,0,0,2,2,2
2,2,2,2,0,2,2,2
2,2,2,2,1,2,2,2
2,2,2,2,2,2,2,2
4,3
4
3,2
3,4
5,3
4,4
