10,7
2,2,2,2,2,2,2,2,2,2
2,2,0,0,0,0,0,2,2,2
2,2,0,2,2,2,0,0,0,2
2,0,0,0,0,0,0,0,0,2
2,0,1,1,2,0,0,0,2,2
2,2,1,1,2,0,0,0,2,2
2,2,2,2,2,2,2,2,2,2
2,3
4
2,2
4,3
6,4
7,3
