19,11
2,2,2,2,2,2,2,2,2,2,2,2,2,2,2,2,2,2,2
2,2,2,2,2,0,0,0,2,2,2,2,2,2,2,2,2,2,2
2,2,2,2,2,0,0,0,2,2,2,2,2,2,2,2,2,2,2
2,2,2,2,2,0,0,0,2,2,2,2,2,2,2,2,2,2,2
2,2,2,0,0,0,0,0,0,0,2,2,2,2,2,2,2,2,2
2,2,2,0,2,0,2,2,2,0,2,2,2,2,2,2,2,2,2
2,0,0,0,2,0,2,2,2,0,2,2,2,2,0,0,1,1,2
2,0,0,0,0,0,0,0,0,0,0,0,0,0,0,0,1,1,2
2,2,2,2,2,0,2,2,2,2,0,2,0,2,0,0,1,1,2
2,2,2,2,2,0,0,0,0,0,0,2,2,2,2,2,2,2,2
2,2,2,2,2,2,2,2,2,2,2,2,2,2,2,2,2,2,2
12,8
6
2,7
5,2
5,4
5,7
7,3
8,4
