14,10
2,2,2,2,2,2,2,2,2,2,2,2,2,2
2,1,1,0,0,2,0,0,0,0,0,2,2,2
2,1,1,0,0,2,0,0,0,0,0,0,0,2
2,1,1,0,0,2,0,2,2,2,2,0,0,2
2,1,1,0,0,0,0,0,0,2,2,0,0,2
2,1,1,0,0,2,0,2,0,0,0,0,2,2
2,2,2,2,2,2,0,2,2,0,0,0,0,2
2,2,2,0,0,0,0,0,0,0,0,0,0,2
2,2,2,0,0,0,0,2,0,0,0,0,0,2
2,2,2,2,2,2,2,2,2,2,2,2,2,2
7,4
10
4,7
6,3
7,2
7,7
9,6
9,7
10,2
10,5
11,6
11,7
